//MAP CONVERTED BY dmm2tgm.py THIS HEADER COMMENT PREVENTS RECONVERSION, DO NOT REMOVE
"aa" = (
/turf/closed/mineral/random/snow/underground,
/area/ruin/icemoon_syndicate/tunnel/sat_base)
"aF" = (
/obj/effect/mob_spawn/ghost_role/human/lavaland_syndicate/icemoon/researcher{
	dir = 4
	},
/turf/open/floor/wood,
/area/ruin/icemoon_syndicate/crew)
"aG" = (
/turf/template_noop,
/area/ruin/icemoon_syndicate/bar)
"aQ" = (
/turf/open/floor/plating/snowed/smoothed/icemoon,
/area/template_noop)
"aY" = (
/obj/structure/cable,
/mob/living/basic/mining/wolf,
/turf/open/floor/plating/snowed/smoothed/icemoon,
/area/template_noop)
"aZ" = (
/obj/effect/mob_spawn/ghost_role/human/lavaland_syndicate/icemoon/researcher/interdyne{
	dir = 4
	},
/turf/open/floor/wood,
/area/ruin/icemoon_syndicate/crew)
"bW" = (
/turf/open/floor/wood,
/area/ruin/icemoon_syndicate/crew)
"cm" = (
/obj/machinery/door/airlock/external,
/obj/effect/mapping_helpers/airlock/cutaiwire,
/obj/effect/mapping_helpers/airlock/access/all/syndicate/general,
/obj/structure/cable,
/turf/open/floor/plating,
/area/ruin/icemoon_syndicate/cargo)
"dr" = (
/obj/machinery/door/airlock/mining,
/obj/effect/mapping_helpers/airlock/cutaiwire,
/obj/effect/mapping_helpers/airlock/access/all/syndicate/general,
/obj/structure/cable,
/turf/open/floor/iron/dark,
/area/ruin/icemoon_syndicate/cargo)
"eu" = (
/obj/machinery/door/airlock/security{
	name = "Checkpoint"
	},
/obj/effect/mapping_helpers/airlock/cutaiwire,
/obj/effect/mapping_helpers/airlock/access/all/syndicate/general,
/turf/open/floor/iron/dark,
/area/ruin/icemoon_syndicate/checkpoint)
"eK" = (
/obj/structure/fluff/tram_rail{
	dir = 1
	},
/obj/item/stack/rods,
/turf/open/lava/plasma/ice_moon,
/area/template_noop)
"eX" = (
/turf/open/misc/asteroid/snow/icemoon,
/area/template_noop)
"fm" = (
/obj/effect/decal/cleanable/blood/tracks,
/turf/open/misc/asteroid/snow/icemoon,
/area/template_noop)
"hx" = (
/obj/structure/lattice/catwalk,
/turf/open/lava/plasma/ice_moon,
/area/icemoon/underground/explored)
"hF" = (
/obj/structure/table/reinforced,
/obj/item/paper_bin{
	pixel_x = 11;
	pixel_y = 4
	},
/obj/item/pen{
	pixel_x = 11;
	pixel_y = 5
	},
/turf/open/floor/iron/dark,
/area/ruin/icemoon_syndicate/cargo)
"hO" = (
/turf/closed/wall,
/area/ruin/icemoon_syndicate/tunnel)
"ih" = (
/obj/structure/railing{
	dir = 8
	},
/turf/open/floor/plating/snowed/smoothed/icemoon,
/area/icemoon/underground/explored)
"iE" = (
/turf/closed/wall,
/area/ruin/icemoon_syndicate/crew)
"jj" = (
/obj/structure/cable,
/obj/structure/fence/door{
	dir = 4
	},
/turf/open/misc/asteroid/snow/icemoon,
/area/template_noop)
"jn" = (
/turf/open/misc/dirt/station,
/area/ruin/icemoon_syndicate/tunnel/sat_base)
"kh" = (
/obj/structure/fluff/tram_rail/floor{
	dir = 1
	},
/obj/structure/closet/crate/cardboard,
/obj/item/food/rationpack{
	pixel_x = -7;
	pixel_y = 2
	},
/obj/item/food/rationpack{
	pixel_x = -6;
	pixel_y = 1
	},
/obj/item/food/rationpack{
	pixel_x = -7;
	pixel_y = 0
	},
/obj/item/food/rationpack{
	pixel_x = -6;
	pixel_y = -1
	},
/obj/item/food/rationpack{
	pixel_x = -7;
	pixel_y = -2
	},
/obj/item/food/rationpack{
	pixel_x = -6;
	pixel_y = -3
	},
/obj/item/reagent_containers/cup/glass/waterbottle/large{
	pixel_x = 4;
	pixel_y = 0
	},
/obj/item/reagent_containers/cup/glass/waterbottle/large{
	pixel_x = 5;
	pixel_y = 0
	},
/obj/item/reagent_containers/cup/glass/waterbottle/large{
	pixel_x = 7;
	pixel_y = 0
	},
/turf/open/floor/plating/snowed/icemoon,
/area/template_noop)
"ku" = (
/obj/machinery/camera/directional/north{
	network = list("icemoon_syndie");
	c_tag = "Checkpoint External"
	},
/turf/open/floor/plating/snowed/smoothed/icemoon,
/area/icemoon/underground/explored)
"lF" = (
/obj/effect/mob_spawn/ghost_role/human/lavaland_syndicate/icemoon/engineer{
	dir = 4
	},
/turf/open/floor/wood,
/area/ruin/icemoon_syndicate/crew)
"mL" = (
/obj/structure/fluff/minepost,
/obj/item/flashlight/lantern/syndicate{
	on = 1;
	pixel_x = 10;
	pixel_y = -10
	},
/turf/open/misc/dirt/station,
/area/ruin/icemoon_syndicate/tunnel/sat_base)
"mU" = (
/obj/structure/table/reinforced,
/obj/item/stamp/granted{
	pixel_x = 3;
	pixel_y = 12
	},
/obj/item/stamp/denied{
	pixel_x = -8;
	pixel_y = 11
	},
/obj/item/stamp/syndicate{
	pixel_x = -2;
	pixel_y = 9
	},
/obj/structure/cable,
/turf/open/floor/iron/dark,
/area/ruin/icemoon_syndicate/cargo)
"oI" = (
/obj/structure/fence/door/opened,
/turf/open/misc/asteroid/snow/icemoon,
/area/template_noop)
"oW" = (
/obj/machinery/door/poddoor/shutters{
	id = list("icemoon_syndie");
	dir = 1
	},
/turf/open/floor/plating,
/area/ruin/icemoon_syndicate/checkpoint)
"pl" = (
/obj/structure/lattice,
/obj/structure/cable,
/turf/open/lava/plasma/ice_moon,
/area/template_noop)
"qn" = (
/obj/machinery/door/window/brigdoor/left/directional/east{
	req_access = list("syndicate");
	name = "Ammunition Storage"
	},
/turf/open/floor/iron/dark,
/area/ruin/icemoon_syndicate/checkpoint)
"qr" = (
/obj/structure/fluff/tram_rail{
	dir = 1
	},
/turf/open/lava/plasma/ice_moon,
/area/template_noop)
"qO" = (
/turf/closed/wall/r_wall,
/area/ruin/icemoon_syndicate/communications)
"qQ" = (
/obj/machinery/autolathe/hacked,
/turf/open/floor/iron/dark,
/area/ruin/icemoon_syndicate/cargo)
"rc" = (
/obj/structure/cable,
/turf/closed/wall/ice,
/area/template_noop)
"sc" = (
/obj/structure/fluff/tram_rail/floor{
	dir = 1
	},
/turf/open/floor/plating/snowed/icemoon,
/area/template_noop)
"sI" = (
/obj/structure/flora/tree/dead/style_3,
/turf/open/misc/asteroid/snow/icemoon,
/area/template_noop)
"sS" = (
/turf/open/floor/iron/dark,
/area/ruin/icemoon_syndicate/checkpoint)
"tj" = (
/turf/open/lava/plasma/ice_moon,
/area/icemoon/underground/explored)
"tu" = (
/obj/effect/mob_spawn/ghost_role/human/lavaland_syndicate/icemoon/surgeon{
	dir = 4
	},
/turf/open/floor/wood,
/area/ruin/icemoon_syndicate/crew)
"tM" = (
/turf/closed/wall/r_wall,
/area/ruin/icemoon_syndicate/tunnel/sat_base)
"uc" = (
/obj/structure/fence/end{
	dir = 1
	},
/turf/open/misc/asteroid/snow/icemoon,
/area/template_noop)
"vc" = (
/obj/structure/fluff/tram_rail,
/turf/open/misc/asteroid/snow/icemoon,
/area/template_noop)
"vg" = (
/obj/structure/fence/cut/large{
	dir = 4
	},
/turf/open/misc/asteroid/snow/icemoon,
/area/template_noop)
"vx" = (
/obj/structure/fluff/tram_rail/floor,
/turf/open/floor/plating/snowed/icemoon,
/area/template_noop)
"vU" = (
/obj/structure/cable,
/turf/open/floor/iron/dark,
/area/ruin/icemoon_syndicate/cargo)
"xn" = (
/obj/structure/flora/tree/dead/style_5,
/turf/open/misc/asteroid/snow/icemoon,
/area/template_noop)
"xF" = (
/obj/structure/fence/end{
	dir = 4
	},
/turf/closed/mineral/random/snow/underground,
/area/template_noop)
"yl" = (
/obj/machinery/door/poddoor/shutters{
	id = "icemoon_syndie_checkpoint_exterior"
	},
/obj/structure/fans/tiny/forcefield,
/turf/open/floor/plating,
/area/ruin/icemoon_syndicate/checkpoint)
"yH" = (
/obj/structure/table/reinforced,
/obj/machinery/fax{
	syndicate_network = 1;
	visible_to_network = 0;
	name = "cargo bay fax machine";
	fax_name = "Syndicate Joint Base Cargo Department";
	pixel_x = 0;
	pixel_y = 9
	},
/turf/open/floor/iron/dark,
/area/ruin/icemoon_syndicate/cargo)
"yU" = (
/obj/structure/cable,
/turf/open/floor/plating/snowed/smoothed/icemoon,
/area/template_noop)
"yV" = (
/obj/machinery/door/poddoor/shutters{
	id = "icemoon_syndie_checkpoint_exterior";
	dir = 1
	},
/turf/open/floor/plating,
/area/ruin/icemoon_syndicate/checkpoint)
"yW" = (
/obj/structure/table/reinforced/plastitaniumglass,
/obj/item/storage/toolbox/syndicate{
	pixel_x = -6;
	pixel_y = -8
	},
/obj/item/stack/sheet/iron/fifty{
	pixel_x = 5;
	pixel_y = 12
	},
/obj/item/stack/sheet/iron/fifty{
	pixel_x = -9;
	pixel_y = 13
	},
/obj/item/stack/sheet/glass{
	amount = 25;
	pixel_x = -2;
	pixel_y = 22
	},
/turf/open/floor/iron/dark,
/area/ruin/icemoon_syndicate/checkpoint)
"zb" = (
/obj/structure/fence/end,
/turf/closed/mineral/random/snow/underground,
/area/template_noop)
"zg" = (
/turf/open/floor/plating/snowed/smoothed/icemoon,
/area/icemoon/underground/explored)
"zZ" = (
/obj/structure/cable,
/obj/effect/decal/cleanable/blood/tracks,
/turf/open/floor/plating/snowed/smoothed/icemoon,
/area/template_noop)
"Aa" = (
/obj/structure/fence/door,
/turf/open/misc/asteroid/snow/icemoon,
/area/template_noop)
"Ae" = (
/obj/machinery/camera/directional/east{
	network = list("icemoon_syndie");
	c_tag = "Checkpoint Waiting Area"
	},
/turf/open/floor/iron/dark,
/area/ruin/icemoon_syndicate/checkpoint)
"Ao" = (
/obj/structure/fluff/tram_rail/anchor{
	dir = 1
	},
/turf/open/misc/asteroid/snow/icemoon,
/area/template_noop)
"Ax" = (
/obj/structure/railing{
	dir = 4
	},
/turf/open/floor/plating/snowed/smoothed/icemoon,
/area/icemoon/underground/explored)
"AF" = (
/obj/structure/cable,
/turf/open/floor/plating,
/area/ruin/icemoon_syndicate/cargo)
"Dg" = (
/turf/template_noop,
/area/template_noop)
"Ds" = (
/obj/structure/fluff/tram_rail/end{
	dir = 8
	},
/turf/open/misc/asteroid/snow/icemoon,
/area/template_noop)
"DD" = (
/obj/effect/mob_spawn/ghost_role/human/lavaland_syndicate/icemoon/guard{
	dir = 4
	},
/turf/open/floor/wood,
/area/ruin/icemoon_syndicate/crew)
"DO" = (
/turf/closed/mineral/random/snow/underground,
/area/icemoon/underground/explored)
"Eu" = (
/obj/structure/flora/tree/dead/style_4,
/turf/open/misc/asteroid/snow/icemoon,
/area/template_noop)
"EH" = (
/turf/closed/mineral/random/snow/underground,
/area/template_noop)
"EP" = (
/obj/structure/shipping_container/gorlex{
	desc = "A standard-measure shipping container for bulk transport of goods. This one is from Gorlex Securities, and is probably carrying their primary export: war crimes. Its doors have rusted shut."
	},
/turf/open/misc/asteroid/snow/icemoon,
/area/template_noop)
"EU" = (
/obj/structure/fluff/tram_rail/anchor,
/turf/open/misc/asteroid/snow/icemoon,
/area/template_noop)
"EZ" = (
/obj/structure/lattice/catwalk,
/obj/structure/railing{
	dir = 8
	},
/turf/open/lava/plasma/ice_moon,
/area/icemoon/underground/explored)
"Fh" = (
/turf/template_noop,
/area/ruin/icemoon_syndicate/research)
"Fn" = (
/obj/structure/fence{
	dir = 4
	},
/turf/open/misc/asteroid/snow/icemoon,
/area/template_noop)
"FP" = (
/obj/structure/table/reinforced/plastitaniumglass,
/obj/item/ammo_box/magazine/c40sol_rifle/standard{
	pixel_x = -4;
	pixel_y = 10
	},
/obj/item/ammo_box/magazine/c40sol_rifle/standard{
	pixel_x = -5;
	pixel_y = 9
	},
/obj/item/ammo_box/magazine/c40sol_rifle/standard{
	pixel_x = -7;
	pixel_y = 8
	},
/obj/item/ammo_box/magazine/c40sol_rifle/standard{
	pixel_x = -9;
	pixel_y = 7
	},
/obj/item/ammo_box/magazine/c40sol_rifle/drum{
	pixel_x = 5;
	pixel_y = 3
	},
/obj/item/ammo_box/magazine/c40sol_rifle/drum{
	pixel_x = 8;
	pixel_y = 6
	},
/obj/item/ammo_box/magazine/c35sol_pistol/stendo{
	pixel_x = -1;
	pixel_y = -1
	},
/obj/item/ammo_box/magazine/c35sol_pistol/stendo{
	pixel_x = -3;
	pixel_y = -3
	},
/obj/item/ammo_box/magazine/c35sol_pistol/stendo{
	pixel_x = -6;
	pixel_y = -5
	},
/obj/item/ammo_box/magazine/c35sol_pistol/stendo{
	pixel_x = -9;
	pixel_y = -6
	},
/turf/open/floor/iron/dark,
/area/ruin/icemoon_syndicate/checkpoint)
"FS" = (
/obj/structure/cable,
/turf/open/misc/asteroid/snow/icemoon,
/area/template_noop)
"Gd" = (
/obj/structure/lattice/catwalk,
/obj/structure/railing,
/obj/structure/railing{
	dir = 1
	},
/turf/open/lava/plasma/ice_moon,
/area/template_noop)
"Gs" = (
/turf/closed/wall/ice,
/area/template_noop)
"Hk" = (
/obj/structure/lattice/catwalk,
/obj/structure/railing{
	dir = 4
	},
/turf/open/lava/plasma/ice_moon,
/area/icemoon/underground/explored)
"HB" = (
/obj/structure/table/reinforced/plastitaniumglass,
/turf/open/floor/iron/dark,
/area/ruin/icemoon_syndicate/checkpoint)
"Ih" = (
/obj/structure/fluff/tram_rail,
/mob/living/basic/mining/wolf,
/turf/open/misc/asteroid/snow/icemoon,
/area/template_noop)
"IJ" = (
/turf/open/floor/iron/dark,
/area/ruin/icemoon_syndicate/cargo)
"IP" = (
/turf/open/lava/plasma/ice_moon,
/area/template_noop)
"Jq" = (
/obj/structure/fluff/tram_rail/end,
/turf/open/misc/asteroid/snow/icemoon,
/area/template_noop)
"JH" = (
/obj/structure/fluff/tram_rail/end{
	dir = 1
	},
/turf/open/misc/asteroid/snow/icemoon,
/area/template_noop)
"JL" = (
/obj/machinery/door/airlock/external,
/turf/open/floor/plating,
/area/ruin/icemoon_syndicate/tunnel)
"Kj" = (
/turf/closed/wall,
/area/ruin/icemoon_syndicate/cargo)
"KJ" = (
/obj/structure/fence,
/turf/open/misc/asteroid/snow/icemoon,
/area/template_noop)
"KT" = (
/turf/template_noop,
/area/ruin/icemoon_syndicate/engineering)
"Lb" = (
/turf/open/floor/plating,
/area/ruin/icemoon_syndicate/tunnel/sat_base)
"Lw" = (
/obj/structure/window/reinforced/spawner/directional/east,
/obj/machinery/autolathe/hacked,
/turf/open/floor/circuit/red/anim,
/area/ruin/icemoon_syndicate/checkpoint)
"Mk" = (
/turf/template_noop,
/area/ruin/icemoon_syndicate/tunnel)
"Ne" = (
/turf/closed/wall/r_wall,
/area/ruin/icemoon_syndicate/vault)
"Nn" = (
/turf/template_noop,
/area/ruin/icemoon_syndicate/vault)
"NG" = (
/obj/machinery/button/door/directional/east{
	id = "icemoon_syndie_checkpoint_in";
	req_access = list("access_syndicate");
	name = "Interior Gate";
	pixel_x = 24;
	pixel_y = 9
	},
/turf/open/floor/iron/dark,
/area/ruin/icemoon_syndicate/checkpoint)
"Pp" = (
/obj/structure/window/reinforced/spawner/directional/east,
/obj/machinery/ammo_workbench/unlocked,
/obj/item/disk/ammo_workbench/advanced{
	pixel_x = -9;
	pixel_y = 3
	},
/turf/open/floor/circuit/red/anim,
/area/ruin/icemoon_syndicate/checkpoint)
"Py" = (
/mob/living/basic/mining/wolf,
/turf/open/misc/asteroid/snow/icemoon,
/area/template_noop)
"PA" = (
/obj/structure/lattice/catwalk,
/obj/structure/cable,
/turf/open/lava/plasma/ice_moon,
/area/template_noop)
"PD" = (
/obj/structure/fluff/tram_rail,
/turf/open/lava/plasma/ice_moon,
/area/template_noop)
"Qj" = (
/obj/structure/fluff/tram_rail/end{
	dir = 4
	},
/turf/open/misc/asteroid/snow/icemoon,
/area/template_noop)
"Sm" = (
/obj/structure/flora/tree/dead/style_6,
/turf/open/misc/asteroid/snow/icemoon,
/area/template_noop)
"TA" = (
/turf/open/floor/plating,
/area/ruin/icemoon_syndicate/tunnel)
"TC" = (
/obj/structure/sign/warning/secure_area/directional/south,
/turf/open/misc/asteroid/snow/icemoon,
/area/template_noop)
"Ua" = (
/turf/open/misc/asteroid/snow/icemoon,
/area/icemoon/underground/explored)
"Un" = (
/turf/closed/wall,
/area/ruin/icemoon_syndicate/bar)
"UX" = (
/obj/structure/lattice,
/turf/open/lava/plasma/ice_moon,
/area/icemoon/underground/explored)
"Vd" = (
/obj/machinery/camera/directional/north{
	network = list("icemoon_syndie");
	c_tag = "Checkpoint Office"
	},
/turf/open/floor/iron/dark,
/area/ruin/icemoon_syndicate/checkpoint)
"Vg" = (
/obj/effect/mob_spawn/ghost_role/human/lavaland_syndicate/icemoon/captain{
	dir = 8
	},
/turf/template_noop,
/area/ruin/icemoon_syndicate/communications)
"Vj" = (
/turf/template_noop,
/area/ruin/icemoon_syndicate/shelter)
"Vq" = (
/turf/closed/wall/r_wall,
/area/ruin/icemoon_syndicate/shelter)
"VG" = (
/obj/structure/filingcabinet,
/turf/open/floor/iron/dark,
/area/ruin/icemoon_syndicate/cargo)
"VU" = (
/turf/closed/wall/r_wall,
/area/ruin/icemoon_syndicate/research)
"VW" = (
/turf/template_noop,
/area/ruin/icemoon_syndicate/communications)
"VX" = (
/obj/structure/flora/tree/dead/style_random,
/turf/open/misc/asteroid/snow/icemoon,
/area/template_noop)
"Wl" = (
/turf/closed/wall/r_wall,
/area/ruin/icemoon_syndicate/checkpoint)
"WJ" = (
/obj/structure/table/reinforced/plastitaniumglass,
/obj/item/storage/box/lethalshot{
	pixel_x = 5;
	pixel_y = 2
	},
/obj/item/storage/box/lethalshot{
	pixel_x = 7;
	pixel_y = -6
	},
/obj/item/storage/box/rubbershot{
	pixel_x = -3;
	pixel_y = 1
	},
/obj/item/storage/box/rubbershot{
	pixel_x = -3;
	pixel_y = -6
	},
/obj/item/storage/toolbox/ammobox/a762{
	pixel_x = -7;
	pixel_y = 11
	},
/obj/item/storage/toolbox/ammobox/a762{
	pixel_x = -8;
	pixel_y = 8
	},
/turf/open/floor/iron/dark,
/area/ruin/icemoon_syndicate/checkpoint)
"Xd" = (
/obj/machinery/computer/security{
	dir = 1;
	network = list("icemoon_syndie")
	},
/turf/open/floor/iron/dark,
/area/ruin/icemoon_syndicate/checkpoint)
"Xj" = (
/obj/item/stack/rods,
/turf/open/lava/plasma/ice_moon,
/area/template_noop)
"XF" = (
/obj/item/stack/rods,
/turf/open/lava/plasma/ice_moon,
/area/icemoon/underground/explored)
"XQ" = (
/obj/effect/decal/remains/human,
/obj/effect/decal/cleanable/blood/old,
/turf/open/misc/asteroid/snow/icemoon,
/area/template_noop)
"Yy" = (
/obj/structure/sign/warning/secure_area/directional/north,
/turf/template_noop,
/area/template_noop)
"Ze" = (
/obj/machinery/door/window/left/directional/west{
	req_access = list("syndicate")
	},
/obj/structure/table/reinforced/plastitaniumglass,
/turf/open/floor/iron/dark,
/area/ruin/icemoon_syndicate/checkpoint)
"ZC" = (
/obj/structure/fluff/tram_rail{
	dir = 1
	},
/turf/open/misc/asteroid/snow/icemoon,
/area/template_noop)

(1,1,1) = {"
Dg
Dg
Dg
Dg
Dg
Dg
Dg
Dg
Dg
Dg
Dg
Dg
Dg
Dg
Dg
Dg
Dg
Dg
Dg
Dg
Dg
Dg
Dg
Dg
Dg
Dg
Dg
Dg
Dg
Dg
Dg
Dg
Dg
Dg
Dg
Dg
Dg
Dg
Dg
Dg
Dg
Dg
Dg
Dg
Dg
Dg
Dg
Dg
"}
(2,1,1) = {"
Dg
Dg
Dg
Dg
Dg
Dg
Dg
Dg
Dg
Dg
Dg
Dg
Dg
IP
IP
IP
IP
IP
IP
IP
Dg
Dg
Dg
Dg
Dg
Dg
Dg
Dg
Dg
Dg
Dg
Dg
Dg
Dg
Dg
Dg
Dg
Dg
Dg
Dg
Dg
Dg
Dg
Dg
Dg
Dg
Dg
Dg
"}
(3,1,1) = {"
Dg
Dg
Dg
Dg
Dg
Dg
Dg
Dg
Dg
IP
IP
IP
IP
IP
IP
IP
IP
IP
IP
IP
IP
IP
IP
Dg
Dg
Dg
Dg
Dg
Dg
Dg
Dg
Dg
Dg
Dg
Dg
Dg
Dg
Dg
Dg
Dg
Dg
Dg
Dg
Dg
Dg
Dg
Dg
Dg
"}
(4,1,1) = {"
Dg
Dg
Dg
Dg
Dg
Dg
Dg
IP
IP
IP
IP
IP
IP
IP
IP
IP
IP
IP
IP
IP
IP
IP
IP
IP
IP
Dg
Dg
Dg
Dg
Dg
Dg
Dg
Dg
Dg
Dg
Dg
Dg
Dg
Dg
Dg
Dg
Dg
Dg
Dg
Dg
Dg
Dg
Dg
"}
(5,1,1) = {"
Dg
Dg
Dg
Dg
Dg
Dg
IP
IP
IP
IP
IP
IP
IP
IP
aa
aa
aa
aa
aa
IP
IP
IP
IP
IP
IP
IP
IP
Dg
Dg
Dg
Dg
Dg
Dg
Dg
Dg
Dg
Dg
Dg
Dg
Dg
Dg
Dg
Dg
Dg
Dg
Dg
Dg
Dg
"}
(6,1,1) = {"
Dg
Dg
Dg
Dg
Dg
IP
IP
IP
IP
IP
IP
IP
aa
aa
aa
qO
qO
qO
aa
aa
IP
IP
IP
IP
IP
IP
IP
IP
Dg
Dg
Dg
Dg
Dg
Dg
Dg
Dg
Dg
Dg
Dg
Dg
Dg
Dg
Dg
Dg
Dg
Dg
Dg
Dg
"}
(7,1,1) = {"
Dg
Dg
Dg
Dg
Dg
IP
IP
IP
IP
IP
aa
aa
aa
aa
qO
qO
VW
qO
qO
aa
aa
aa
aa
IP
IP
IP
IP
IP
IP
Dg
Dg
Dg
Dg
Dg
Dg
Dg
Dg
Dg
Dg
Dg
Dg
Dg
Dg
Dg
Dg
Dg
Dg
Dg
"}
(8,1,1) = {"
Dg
Dg
Dg
Dg
Dg
IP
IP
IP
IP
IP
aa
qO
qO
qO
qO
VW
VW
VW
qO
qO
qO
aa
aa
aa
IP
IP
IP
IP
IP
IP
Dg
Dg
Dg
Dg
Dg
Dg
Dg
Dg
Dg
Dg
Dg
Dg
Dg
Dg
Dg
Dg
Dg
Dg
"}
(9,1,1) = {"
Dg
Dg
Dg
Dg
IP
IP
IP
IP
IP
eX
aa
qO
VW
VW
VW
VW
VW
VW
VW
VW
qO
aa
aa
aa
aa
aa
IP
IP
IP
IP
IP
IP
Dg
Dg
Dg
Dg
Dg
Dg
Dg
Dg
Dg
Dg
Dg
Dg
Dg
Dg
Dg
Dg
"}
(10,1,1) = {"
Dg
Dg
Dg
Dg
IP
IP
IP
IP
eX
eX
aa
qO
VW
VW
qO
VW
VW
VW
VW
qO
qO
aa
aa
aa
aa
IP
IP
IP
IP
IP
IP
IP
IP
Dg
Dg
Dg
Dg
Dg
Dg
Dg
Dg
Dg
Dg
Dg
Dg
Dg
Dg
Dg
"}
(11,1,1) = {"
Dg
Dg
Dg
Dg
IP
IP
IP
eX
eX
eX
aa
qO
Vg
qO
qO
qO
VW
qO
qO
qO
aa
aa
aa
aa
aa
IP
IP
IP
IP
IP
IP
IP
IP
IP
Dg
Dg
Dg
Dg
Dg
Dg
Dg
Dg
Dg
Dg
Dg
Dg
Dg
Dg
"}
(12,1,1) = {"
Dg
Dg
Dg
Dg
IP
IP
IP
eX
eX
eX
eX
tM
tM
tM
aa
mL
jn
jn
jn
aa
aa
aa
aa
aa
IP
IP
IP
IP
IP
IP
IP
IP
IP
IP
IP
Dg
Dg
Dg
Dg
Dg
Dg
Dg
Dg
Dg
Dg
Dg
Dg
Dg
"}
(13,1,1) = {"
Dg
Dg
Dg
Dg
IP
IP
IP
eX
eX
aQ
aQ
Lb
Lb
Lb
jn
jn
jn
jn
aa
aa
aa
aa
aa
IP
IP
IP
IP
IP
IP
IP
IP
IP
IP
IP
IP
IP
Dg
Dg
Dg
Dg
Dg
Dg
Dg
Dg
Dg
Dg
Dg
Dg
"}
(14,1,1) = {"
Dg
Dg
Dg
Dg
IP
IP
IP
IP
eX
aQ
eX
tM
tM
tM
Ne
Ne
Nn
Ne
Ne
aa
aa
aa
aa
IP
IP
IP
IP
IP
IP
IP
IP
IP
IP
IP
IP
IP
Dg
Dg
Dg
Dg
Dg
Dg
Dg
Dg
Dg
Dg
Dg
Dg
"}
(15,1,1) = {"
Dg
Dg
Dg
Dg
IP
IP
IP
IP
eX
aQ
eX
aa
aa
aa
Ne
Nn
Nn
Nn
Ne
aa
aa
aa
aa
IP
IP
IP
IP
IP
IP
IP
IP
IP
IP
IP
IP
IP
Dg
Dg
Dg
Dg
Dg
Dg
Dg
Dg
Dg
Dg
Dg
Dg
"}
(16,1,1) = {"
Dg
Dg
Dg
Dg
IP
IP
IP
IP
eX
aQ
eX
aa
aa
aa
Ne
Nn
Nn
Nn
Ne
aa
aa
aa
IP
IP
IP
IP
IP
IP
IP
IP
IP
IP
IP
IP
IP
IP
IP
Dg
Dg
Dg
Dg
Dg
Dg
Dg
Dg
Dg
Dg
Dg
"}
(17,1,1) = {"
Dg
Dg
Dg
Dg
IP
IP
IP
IP
IP
Gd
eX
aa
aa
aa
Ne
Ne
Nn
Ne
Ne
aa
aa
IP
IP
IP
IP
IP
IP
IP
IP
IP
IP
IP
IP
IP
IP
IP
IP
Dg
Dg
Dg
Dg
Dg
Dg
Dg
Dg
Dg
Dg
Dg
"}
(18,1,1) = {"
Dg
Dg
Dg
Dg
IP
IP
IP
IP
IP
Gd
eX
eX
aa
aa
aa
Ne
Ne
Ne
aa
aa
IP
IP
IP
IP
IP
IP
IP
IP
IP
IP
IP
IP
IP
IP
IP
IP
IP
IP
Dg
Dg
Dg
Dg
Dg
Dg
Dg
Dg
Dg
Dg
"}
(19,1,1) = {"
Dg
Dg
Dg
Dg
IP
IP
IP
IP
IP
Gd
IP
IP
eX
aa
aa
aa
aa
aa
aa
IP
IP
IP
IP
IP
IP
IP
IP
IP
IP
IP
IP
IP
IP
IP
IP
IP
IP
IP
Dg
Dg
Dg
Dg
Dg
Dg
Dg
Dg
Dg
Dg
"}
(20,1,1) = {"
Dg
Dg
Dg
IP
IP
IP
IP
IP
IP
Gd
IP
IP
IP
IP
IP
IP
IP
aa
IP
IP
IP
IP
IP
IP
IP
IP
IP
IP
IP
IP
IP
IP
IP
IP
IP
IP
IP
IP
Dg
Dg
Dg
Dg
Dg
Dg
Dg
Dg
Dg
Dg
"}
(21,1,1) = {"
Dg
Dg
Dg
IP
IP
IP
IP
IP
IP
Gd
IP
IP
IP
IP
IP
IP
IP
IP
IP
IP
IP
IP
IP
IP
IP
IP
IP
IP
IP
IP
IP
IP
IP
IP
IP
IP
IP
IP
Dg
Dg
Dg
Dg
Dg
Dg
Dg
Dg
Dg
Dg
"}
(22,1,1) = {"
Dg
Dg
Dg
IP
IP
IP
IP
IP
IP
Gd
IP
IP
IP
IP
IP
IP
IP
IP
IP
IP
IP
IP
IP
IP
IP
IP
IP
IP
IP
IP
IP
IP
IP
IP
IP
IP
IP
IP
Dg
Dg
Dg
Dg
Dg
Dg
Dg
Dg
Dg
Dg
"}
(23,1,1) = {"
Dg
Dg
Dg
IP
IP
IP
IP
IP
IP
Gd
IP
IP
IP
IP
IP
IP
IP
IP
IP
IP
IP
IP
IP
IP
IP
IP
IP
IP
IP
IP
IP
IP
IP
IP
IP
IP
IP
IP
Dg
Dg
Dg
Dg
Dg
Dg
Dg
Dg
Dg
Dg
"}
(24,1,1) = {"
Dg
Dg
IP
IP
IP
IP
IP
IP
IP
Gd
IP
IP
EH
EH
EH
EH
EH
EH
IP
IP
IP
IP
IP
IP
IP
IP
IP
IP
IP
IP
IP
IP
IP
IP
IP
IP
IP
IP
Dg
Dg
Dg
Dg
Dg
Dg
Dg
Dg
Dg
Dg
"}
(25,1,1) = {"
Dg
Dg
IP
IP
IP
IP
IP
IP
IP
Gd
IP
EH
EH
EH
EH
EH
EH
EH
EH
EH
EH
IP
IP
IP
IP
IP
IP
IP
IP
IP
IP
IP
IP
IP
IP
IP
IP
IP
Dg
Dg
Dg
Dg
Dg
Dg
Dg
Dg
Dg
Dg
"}
(26,1,1) = {"
Dg
IP
IP
IP
IP
IP
IP
IP
IP
aQ
eX
EH
EH
EH
EH
EH
EH
EH
EH
EH
EH
EH
EH
IP
IP
IP
IP
IP
IP
IP
IP
IP
IP
IP
IP
IP
IP
IP
Dg
Dg
Dg
Dg
Dg
Dg
Dg
Dg
Dg
Dg
"}
(27,1,1) = {"
Dg
IP
IP
IP
IP
IP
IP
IP
hO
JL
hO
EH
EH
EH
EH
VU
VU
VU
VU
VU
VU
VU
EH
EH
EH
EH
IP
IP
IP
IP
IP
IP
IP
IP
IP
IP
IP
IP
IP
Dg
Dg
Dg
Dg
Dg
Dg
Dg
Dg
Dg
"}
(28,1,1) = {"
Dg
IP
IP
IP
IP
IP
IP
IP
hO
TA
hO
Un
Un
Un
Un
VU
Fh
Fh
Fh
Fh
Fh
VU
VU
VU
VU
EH
EH
EH
IP
IP
IP
IP
IP
IP
IP
IP
IP
IP
IP
Dg
Dg
Dg
Dg
Dg
Dg
Dg
Dg
Dg
"}
(29,1,1) = {"
IP
IP
IP
IP
IP
IP
IP
EH
hO
JL
Un
Un
aG
aG
aG
VU
Fh
Fh
Fh
Fh
Fh
Fh
Fh
Fh
VU
VU
EH
EH
EH
IP
IP
IP
IP
IP
IP
IP
IP
IP
IP
Dg
Dg
Dg
Dg
Dg
Dg
Dg
Dg
Dg
"}
(30,1,1) = {"
IP
IP
IP
IP
IP
IP
EH
EH
Mk
Mk
Un
aG
aG
aG
aG
VU
Fh
Fh
Fh
Fh
Fh
Fh
Fh
Fh
Fh
VU
EH
EH
EH
EH
IP
IP
IP
IP
IP
IP
IP
IP
IP
IP
Dg
Dg
Dg
Dg
Dg
Dg
Dg
Dg
"}
(31,1,1) = {"
IP
IP
IP
IP
IP
EH
EH
EH
Mk
Mk
aG
aG
aG
aG
aG
VU
Fh
Fh
Fh
Fh
Fh
Fh
Fh
Fh
Fh
VU
EH
EH
EH
EH
EH
IP
IP
IP
IP
IP
IP
IP
IP
IP
IP
Dg
Dg
Dg
Dg
Dg
Dg
Dg
"}
(32,1,1) = {"
IP
IP
IP
IP
EH
EH
EH
EH
Mk
Mk
Un
aG
aG
aG
aG
VU
Fh
Fh
Fh
Fh
Fh
Fh
Fh
Fh
Fh
VU
Dg
EH
EH
EH
EH
EH
EH
EH
IP
IP
IP
IP
IP
IP
IP
Dg
Dg
Dg
Dg
Dg
Dg
Dg
"}
(33,1,1) = {"
IP
IP
IP
IP
EH
EH
EH
Dg
Mk
Mk
Un
Un
aG
aG
aG
VU
Fh
VU
VU
VU
VU
VU
VU
VU
VU
VU
Dg
Dg
Dg
EH
EH
EH
EH
EH
EH
EH
IP
IP
IP
IP
IP
IP
Dg
Dg
Dg
Dg
Dg
Dg
"}
(34,1,1) = {"
IP
IP
IP
IP
EH
EH
EH
Dg
Mk
Mk
Mk
Un
aG
aG
Un
VU
Fh
Fh
VU
Mk
Mk
Mk
Mk
Dg
Dg
Dg
Dg
Dg
Dg
Dg
Dg
EH
EH
EH
EH
EH
EH
IP
IP
IP
IP
IP
Dg
Dg
Dg
Dg
Dg
Dg
"}
(35,1,1) = {"
IP
IP
IP
IP
EH
EH
Dg
Dg
Mk
Mk
Mk
Mk
Mk
Mk
Mk
VU
Fh
Fh
Fh
Mk
Mk
Mk
Mk
Mk
Dg
Dg
Dg
Dg
Dg
Dg
Dg
Wl
Wl
Wl
Wl
Wl
EH
EH
IP
IP
IP
IP
Dg
Dg
Dg
Dg
Dg
Dg
"}
(36,1,1) = {"
Dg
IP
IP
IP
EH
EH
Dg
Dg
Dg
Mk
Mk
Mk
Mk
Mk
Mk
VU
VU
VU
VU
Mk
Mk
Mk
Mk
Mk
Vq
Vq
Vq
Vq
Vq
Vq
Dg
Wl
yW
FP
WJ
Wl
EH
EH
EH
IP
IP
IP
IP
Dg
Dg
Dg
Dg
Dg
"}
(37,1,1) = {"
Dg
IP
IP
IP
EH
Dg
Dg
Dg
Dg
Dg
Mk
Mk
Mk
Mk
Mk
Mk
Mk
Mk
Mk
Mk
Mk
Mk
Mk
Vq
Vq
Vj
Vj
Vj
Vj
Vq
Mk
Wl
Lw
qn
Pp
Wl
EH
EH
EH
IP
IP
IP
IP
Dg
Dg
Dg
Dg
Dg
"}
(38,1,1) = {"
IP
IP
IP
EH
EH
EH
Dg
Dg
Dg
Dg
Dg
Dg
Mk
Mk
Mk
Mk
Mk
Mk
Mk
Mk
Mk
Mk
Mk
Vj
Vj
Vj
Vj
Vj
Vj
Vq
Mk
Wl
HB
sS
HB
Wl
Wl
EH
IP
IP
IP
IP
IP
Dg
Dg
Dg
Dg
Dg
"}
(39,1,1) = {"
IP
IP
IP
EH
EH
EH
EH
EH
EH
Dg
Dg
Dg
Dg
iE
iE
bW
iE
iE
Dg
Mk
Mk
Mk
Mk
Vq
Vq
Vj
Vj
Vj
Vj
Vq
Mk
eu
sS
sS
sS
Xd
Wl
EH
IP
IP
IP
IP
IP
Dg
Dg
Dg
Dg
Dg
"}
(40,1,1) = {"
IP
IP
IP
eX
EH
EH
EH
EH
EH
EH
Dg
Dg
Dg
iE
aZ
bW
tu
iE
Dg
Mk
Mk
Mk
Mk
Mk
Vq
Vq
Vq
Vq
Vq
Vq
Mk
Wl
Vd
NG
sS
Wl
Wl
EH
Xj
IP
IP
IP
IP
IP
Dg
Dg
Dg
Dg
"}
(41,1,1) = {"
IP
IP
IP
eX
eX
EH
xF
EH
EH
EH
EH
EH
Dg
iE
bW
bW
bW
iE
Dg
Mk
Mk
Mk
Mk
Mk
Dg
Dg
Dg
Dg
Dg
Dg
Mk
Wl
eu
Wl
Ze
Wl
DO
DO
tj
tj
tj
IP
IP
IP
Dg
Dg
Dg
Dg
"}
(42,1,1) = {"
IP
IP
IP
eX
eX
eX
Fn
EH
EH
EH
EH
EH
EH
iE
iE
bW
iE
iE
Dg
Mk
Mk
Mk
Mk
Dg
Dg
Dg
Dg
Dg
Mk
Mk
Mk
Wl
sS
sS
sS
Wl
DO
Ua
tj
tj
tj
tj
tj
tj
tj
Dg
Dg
Dg
"}
(43,1,1) = {"
IP
IP
IP
eX
Sm
eX
Fn
eX
eX
eX
EH
EH
EH
iE
DD
bW
lF
iE
Dg
Mk
Mk
Mk
Mk
Mk
Mk
Mk
Mk
Mk
Mk
Mk
Mk
yV
sS
sS
sS
yl
zg
zg
EZ
UX
tj
UX
UX
EZ
ih
zg
zg
Dg
"}
(44,1,1) = {"
IP
IP
IP
IP
eX
eX
Fn
Qj
Ds
eX
eX
EH
EH
iE
bW
bW
bW
iE
Dg
Mk
Mk
Mk
Mk
Mk
Mk
Mk
Mk
Mk
Mk
Mk
Mk
oW
sS
sS
sS
yl
zg
zg
hx
UX
tj
XF
hx
hx
zg
zg
Dg
zg
"}
(45,1,1) = {"
IP
IP
IP
IP
eX
eX
Gs
Ao
EU
Gs
eX
eX
EH
iE
iE
bW
iE
iE
Dg
Mk
Mk
Mk
Mk
Mk
Mk
Mk
Mk
Mk
Mk
Mk
Mk
Wl
sS
Ae
sS
Wl
ku
zg
Hk
Hk
tj
tj
Hk
UX
Ax
zg
Dg
Dg
"}
(46,1,1) = {"
Dg
IP
IP
IP
eX
eX
Fn
sc
vx
eX
eX
eX
EH
iE
aF
bW
aF
iE
Dg
Mk
Mk
Mk
Mk
Mk
Mk
Mk
Mk
Dg
Dg
Dg
Mk
Wl
Wl
Wl
Wl
Wl
DO
DO
DO
XF
tj
IP
IP
IP
IP
Dg
Dg
Dg
"}
(47,1,1) = {"
Dg
IP
IP
IP
eX
xn
Fn
sc
vx
eX
eX
eX
EH
iE
bW
bW
bW
iE
Dg
Mk
Mk
Mk
Mk
Mk
Mk
Mk
Dg
Dg
Dg
Dg
Dg
Dg
Dg
Dg
Dg
Dg
Dg
EH
EH
IP
IP
IP
IP
IP
IP
Dg
Dg
Dg
"}
(48,1,1) = {"
Dg
IP
IP
IP
eX
eX
Fn
sc
vx
eX
eX
eX
EH
iE
iE
iE
iE
iE
Dg
Dg
Mk
Mk
Mk
Mk
Dg
Dg
Dg
Dg
Dg
Dg
Dg
Dg
Dg
Dg
Dg
Dg
EH
EH
EH
IP
IP
IP
IP
IP
Xj
Dg
Dg
Dg
"}
(49,1,1) = {"
Dg
IP
IP
IP
eX
eX
Gs
Ao
EU
Gs
eX
Eu
EH
EH
EH
EH
Dg
Kj
Kj
Kj
Mk
Mk
Mk
Mk
Mk
Dg
Dg
Dg
Dg
KT
KT
KT
KT
KT
Dg
Dg
EH
EH
EH
IP
IP
IP
IP
IP
IP
Dg
Dg
Dg
"}
(50,1,1) = {"
Dg
IP
IP
IP
IP
eX
Fn
kh
vx
eX
eX
eX
eX
EH
EH
EH
Kj
Kj
yH
Kj
Kj
Mk
Mk
Mk
Mk
Mk
Dg
Dg
KT
KT
KT
KT
KT
KT
Dg
EH
EH
EH
IP
IP
IP
IP
IP
IP
IP
Dg
Dg
Dg
"}
(51,1,1) = {"
Dg
IP
IP
IP
IP
eX
vg
sc
vx
eX
eX
eX
eX
EH
Kj
Kj
Kj
VG
IJ
hF
Kj
Mk
Mk
Mk
Mk
Mk
Dg
Dg
KT
KT
KT
KT
KT
KT
Dg
EH
EH
IP
IP
IP
IP
IP
IP
IP
Dg
Dg
Dg
Dg
"}
(52,1,1) = {"
Dg
IP
IP
IP
IP
IP
Fn
sc
vx
eX
eX
FS
FS
FS
cm
AF
cm
vU
vU
mU
Kj
Mk
Mk
Mk
Mk
Mk
Dg
Dg
KT
KT
KT
KT
KT
KT
Dg
EH
EH
IP
IP
IP
IP
IP
IP
IP
Dg
Dg
Dg
Dg
"}
(53,1,1) = {"
Dg
IP
IP
IP
IP
eX
Gs
Ao
EU
Gs
eX
FS
eX
eX
Kj
Kj
Kj
vU
IJ
vU
dr
Mk
Mk
Mk
Mk
Mk
Mk
Dg
KT
KT
KT
KT
KT
KT
EH
EH
IP
IP
IP
IP
IP
IP
IP
IP
Dg
Dg
Dg
Dg
"}
(54,1,1) = {"
Dg
Dg
IP
IP
IP
IP
IP
ZC
vc
eX
uc
jj
KJ
zb
EH
EH
Kj
Kj
qQ
Kj
Kj
Dg
Dg
Mk
Mk
Mk
Mk
Mk
KT
KT
KT
KT
KT
KT
EH
IP
IP
IP
IP
IP
IP
IP
IP
Dg
Dg
Dg
Dg
Dg
"}
(55,1,1) = {"
Dg
Dg
Dg
IP
IP
IP
IP
ZC
vc
FS
FS
FS
eX
EH
EH
EH
EH
Kj
Kj
Kj
Dg
Dg
Dg
Mk
Mk
Mk
Mk
Mk
KT
KT
KT
KT
KT
EH
EH
IP
IP
IP
IP
IP
IP
IP
IP
Dg
Dg
Dg
Dg
Dg
"}
(56,1,1) = {"
Dg
Dg
Dg
IP
IP
IP
IP
qr
vc
FS
eX
eX
eX
EH
EH
EH
EH
EH
Dg
Dg
Dg
Dg
Dg
Dg
Mk
Mk
Mk
Mk
KT
KT
KT
KT
KT
EH
IP
IP
IP
IP
IP
IP
IP
IP
Dg
Dg
Dg
Dg
Dg
Dg
"}
(57,1,1) = {"
Dg
Dg
Dg
IP
IP
IP
IP
qr
PD
PA
eX
Sm
eX
eX
EH
EH
EH
EH
EH
Dg
Dg
Dg
Dg
Dg
Dg
Dg
Mk
Mk
Mk
EH
EH
EH
EH
EH
IP
IP
IP
IP
IP
IP
IP
Dg
Dg
Dg
Dg
Dg
Dg
Dg
"}
(58,1,1) = {"
Dg
Dg
Dg
Dg
IP
IP
IP
qr
PD
PA
IP
eX
eX
eX
eX
EH
EH
EH
EH
EH
EH
Dg
Dg
Dg
Dg
Dg
Mk
Mk
EH
EH
EH
EH
EH
IP
IP
IP
IP
IP
Dg
Dg
Dg
Dg
Dg
Dg
Dg
Dg
Dg
Dg
"}
(59,1,1) = {"
Dg
Dg
Dg
Dg
IP
IP
IP
qr
PD
pl
IP
Xj
IP
eX
eX
eX
EH
EH
EH
EH
EH
EH
Dg
Dg
Dg
Dg
Dg
EH
EH
EH
EH
EH
IP
IP
IP
IP
IP
IP
Dg
Dg
Dg
Dg
Dg
Dg
Dg
Dg
Dg
Dg
"}
(60,1,1) = {"
Dg
Dg
Dg
Dg
IP
IP
IP
eK
PD
IP
IP
IP
IP
IP
IP
IP
eX
EH
EH
EH
EH
EH
EH
EH
EH
EH
EH
EH
EH
EH
EH
IP
IP
IP
IP
IP
IP
Dg
Dg
Dg
Dg
Dg
Dg
Dg
Dg
Dg
Dg
Dg
"}
(61,1,1) = {"
Dg
Dg
Dg
Dg
Dg
IP
IP
qr
PD
IP
IP
IP
IP
IP
IP
IP
IP
IP
IP
EH
EH
EH
EH
EH
EH
EH
EH
EH
IP
IP
IP
IP
IP
IP
IP
IP
Dg
Dg
Dg
Dg
Dg
Dg
Dg
Dg
Dg
Dg
Dg
Dg
"}
(62,1,1) = {"
Dg
Dg
Dg
Dg
EH
EH
EH
eK
PD
PA
IP
Xj
IP
IP
IP
IP
IP
IP
IP
IP
IP
IP
IP
IP
EH
EH
IP
IP
IP
IP
IP
IP
IP
IP
Dg
Dg
Dg
Dg
Dg
Dg
Dg
Dg
Dg
Dg
Dg
Dg
Dg
Dg
"}
(63,1,1) = {"
Dg
Dg
Dg
EH
EH
EH
Gs
Ao
EU
rc
IP
IP
IP
IP
Xj
IP
IP
IP
IP
IP
IP
IP
IP
IP
IP
IP
IP
IP
IP
IP
IP
IP
Dg
Dg
Dg
Dg
Dg
Dg
Dg
Dg
Dg
Dg
Dg
Dg
Dg
Dg
Dg
Dg
"}
(64,1,1) = {"
Dg
Dg
Dg
EH
EH
Dg
aQ
ZC
vc
yU
Dg
Dg
Dg
IP
IP
IP
IP
IP
IP
IP
IP
IP
IP
IP
IP
IP
IP
IP
IP
IP
IP
Dg
Dg
Dg
Dg
Dg
Dg
Dg
Dg
Dg
Dg
Dg
Dg
Dg
Dg
Dg
Dg
Dg
"}
(65,1,1) = {"
Dg
Dg
xF
EH
EH
Dg
aQ
ZC
vc
yU
Py
Dg
Dg
Dg
xF
Dg
Dg
Dg
Dg
IP
IP
IP
IP
IP
IP
Dg
Dg
Dg
Dg
Dg
Dg
Dg
Dg
Dg
Dg
Dg
Dg
Dg
Dg
Dg
Dg
Dg
Dg
Dg
Dg
Dg
Dg
Dg
"}
(66,1,1) = {"
Dg
VX
Fn
Dg
Dg
eX
aQ
ZC
Ih
zZ
fm
XQ
eX
eX
oI
eX
eX
Dg
Dg
Dg
Dg
Dg
Dg
Dg
Dg
Dg
Dg
Dg
Dg
Dg
Dg
Dg
Dg
Dg
Dg
Dg
Dg
Dg
Dg
Dg
Dg
Dg
Dg
Dg
Dg
Dg
Dg
Dg
"}
(67,1,1) = {"
eX
eX
Aa
eX
eX
eX
Gs
Ao
EU
rc
Dg
Dg
sI
eX
Fn
Dg
eX
eX
Dg
Dg
Dg
Dg
Dg
Dg
Dg
Dg
Dg
Dg
Dg
Dg
Dg
Dg
Dg
Dg
Dg
Dg
Dg
Dg
Dg
Dg
Dg
Dg
Dg
Dg
Dg
Dg
Dg
Dg
"}
(68,1,1) = {"
Dg
TC
Gs
Dg
eX
eX
aQ
ZC
vc
yU
Dg
Dg
Dg
eX
Gs
Yy
Dg
Dg
Dg
Dg
Dg
Dg
Dg
Dg
Dg
Dg
Dg
Dg
Dg
Dg
Dg
Dg
Dg
Dg
Dg
Dg
Dg
Dg
Dg
Dg
Dg
Dg
Dg
Dg
Dg
Dg
Dg
Dg
"}
(69,1,1) = {"
Dg
Dg
EH
EH
EP
Dg
aQ
ZC
vc
aY
Dg
Dg
EH
EH
EH
Dg
Dg
Dg
Dg
Dg
Dg
Dg
Dg
Dg
Dg
Dg
Dg
Dg
Dg
Dg
Dg
Dg
Dg
Dg
Dg
Dg
Dg
Dg
Dg
Dg
Dg
Dg
Dg
Dg
Dg
Dg
Dg
Dg
"}
(70,1,1) = {"
Dg
Dg
Dg
EH
eX
eX
aQ
ZC
vc
yU
Dg
Dg
EH
EH
Dg
Dg
Dg
Dg
Dg
Dg
Dg
Dg
Dg
Dg
Dg
Dg
Dg
Dg
Dg
Dg
Dg
Dg
Dg
Dg
Dg
Dg
Dg
Dg
Dg
Dg
Dg
Dg
Dg
Dg
Dg
Dg
Dg
Dg
"}
(71,1,1) = {"
Dg
Dg
Dg
EH
eX
Dg
Gs
Ao
EU
rc
Dg
EH
EH
EH
Dg
Dg
Dg
Dg
Dg
Dg
Dg
Dg
Dg
Dg
Dg
Dg
Dg
Dg
Dg
Dg
Dg
Dg
Dg
Dg
Dg
Dg
Dg
Dg
Dg
Dg
Dg
Dg
Dg
Dg
Dg
Dg
Dg
Dg
"}
(72,1,1) = {"
Dg
Dg
Dg
EH
EH
Dg
Dg
JH
Jq
Dg
EH
EH
Dg
Dg
Dg
Dg
Dg
Dg
Dg
Dg
Dg
Dg
Dg
Dg
Dg
Dg
Dg
Dg
Dg
Dg
Dg
Dg
Dg
Dg
Dg
Dg
Dg
Dg
Dg
Dg
Dg
Dg
Dg
Dg
Dg
Dg
Dg
Dg
"}
(73,1,1) = {"
Dg
Dg
Dg
Dg
EH
EH
EH
Dg
Dg
EH
EH
Dg
Dg
Dg
Dg
Dg
Dg
Dg
Dg
Dg
Dg
Dg
Dg
Dg
Dg
Dg
Dg
Dg
Dg
Dg
Dg
Dg
Dg
Dg
Dg
Dg
Dg
Dg
Dg
Dg
Dg
Dg
Dg
Dg
Dg
Dg
Dg
Dg
"}
(74,1,1) = {"
Dg
Dg
Dg
Dg
EH
EH
EH
EH
EH
EH
Dg
Dg
Dg
Dg
Dg
Dg
Dg
Dg
Dg
Dg
Dg
Dg
Dg
Dg
Dg
Dg
Dg
Dg
Dg
Dg
Dg
Dg
Dg
Dg
Dg
Dg
Dg
Dg
Dg
Dg
Dg
Dg
Dg
Dg
Dg
Dg
Dg
Dg
"}
