//MAP CONVERTED BY dmm2tgm.py THIS HEADER COMMENT PREVENTS RECONVERSION, DO NOT REMOVE
"aM" = (
/turf/open/misc/asteroid/snow/icemoon,
/area/icemoon/underground/explored)
"bp" = (
/obj/item/hatchet,
/turf/open/misc/dirt/station,
/area/ruin/powered/hermit)
"bM" = (
/obj/structure/fans/tiny/invisible,
/obj/structure/mineral_door/manual_colony_door,
/turf/open/floor/iron/colony/texture,
/area/ruin/powered/hermit)
"cI" = (
/obj/item/storage/toolbox/emergency,
/turf/open/misc/dirt/station,
/area/ruin/powered/hermit)
"dY" = (
/obj/structure/sink/directional/south,
/turf/open/floor/plating,
/area/ruin/powered/hermit)
"ec" = (
/obj/structure/chair/comfy/beige,
/obj/effect/mapping_helpers/burnt_floor,
/turf/open/floor/iron/colony,
/area/ruin/powered/hermit)
"gr" = (
/obj/machinery/portable_atmospherics/canister/oxygen,
/turf/open/misc/dirt/station,
/area/ruin/powered/hermit)
"ha" = (
/obj/effect/mob_spawn/ghost_role/human/hermit,
/turf/open/floor/iron/colony,
/area/ruin/powered/hermit)
"hN" = (
/obj/structure/bonfire/prelit,
/obj/machinery/light/directional/north,
/obj/effect/mapping_helpers/burnt_floor,
/turf/open/floor/iron/colony,
/area/ruin/powered/hermit)
"ii" = (
/obj/item/clothing/suit/hooded/wintercoat,
/turf/open/floor/iron/colony,
/area/ruin/powered/hermit)
"il" = (
/obj/structure/barricade/wooden/crude/snow,
/turf/open/misc/asteroid/snow/icemoon,
/area/icemoon/underground/explored)
"io" = (
/obj/item/storage/bag/plants/portaseeder,
/obj/item/storage/medkit/surgery,
/obj/item/storage/bag/ore,
/obj/structure/table/wood,
/turf/open/floor/grass,
/area/ruin/powered/hermit)
"js" = (
/obj/item/reagent_containers/cup/bottle,
/obj/item/stack/cable_coil,
/obj/item/stack/cable_coil,
/obj/item/stack/cable_coil,
/obj/item/stack/sheet/iron/five,
/obj/item/screwdriver/red,
/turf/open/misc/dirt/station,
/area/ruin/powered/hermit)
"jG" = (
/turf/closed/wall/ice,
/area/icemoon/underground/explored)
"mN" = (
/turf/open/floor/iron/colony,
/area/ruin/powered/hermit)
"mR" = (
/obj/machinery/growing/soil,
/turf/open/misc/dirt/station,
/area/ruin/powered/hermit)
"oh" = (
/turf/open/misc/dirt/station,
/area/ruin/powered/hermit)
"oJ" = (
/obj/structure/glowshroom/single,
/turf/open/misc/dirt/station,
/area/ruin/powered/hermit)
"sj" = (
/obj/machinery/growing/soil,
/obj/machinery/light/directional/north,
/turf/open/floor/grass,
/area/ruin/powered/hermit)
"sC" = (
/obj/item/chair/wood/wings,
/turf/open/floor/iron/colony,
/area/ruin/powered/hermit)
"uw" = (
/obj/machinery/growing/soil,
/turf/open/floor/grass,
/area/ruin/powered/hermit)
"wf" = (
/obj/item/gun/ballistic/rifle/boltaction/pipegun/prime,
/obj/structure/table/wood,
/obj/item/flashlight/lantern,
/turf/open/floor/iron/colony,
/area/ruin/powered/hermit)
"wH" = (
/obj/machinery/light/directional/east,
/turf/open/misc/dirt/station,
/area/ruin/powered/hermit)
"xN" = (
/turf/open/floor/grass,
/area/ruin/powered/hermit)
"zd" = (
/obj/item/pickaxe/improvised,
/obj/structure/table/wood,
/obj/item/knife/combat,
/turf/open/floor/grass,
/area/ruin/powered/hermit)
"CR" = (
/obj/item/flashlight/lantern,
/turf/open/misc/asteroid/snow/icemoon,
/area/icemoon/underground/explored)
"GU" = (
/obj/item/paper/guides/jobs/hydroponics,
/turf/open/misc/dirt/station,
/area/ruin/powered/hermit)
"HD" = (
/obj/structure/reagent_dispensers/fueltank,
/turf/open/misc/dirt/station,
/area/ruin/powered/hermit)
"JI" = (
/obj/effect/mapping_helpers/burnt_floor,
/turf/open/floor/iron/colony,
/area/ruin/powered/hermit)
"Lf" = (
/obj/item/shovel,
/turf/open/misc/dirt/station,
/area/ruin/powered/hermit)
"Qr" = (
/obj/structure/barricade/wooden/snowed,
/turf/open/misc/asteroid/snow/icemoon,
/area/icemoon/underground/explored)
"QD" = (
/turf/template_noop,
/area/template_noop)
"Rd" = (
/obj/item/flashlight/lantern,
/turf/open/floor/grass,
/area/ruin/powered/hermit)
"Rr" = (
/obj/structure/flora/tree/pine/style_random,
/turf/open/misc/asteroid/snow/icemoon,
/area/icemoon/underground/explored)
"Si" = (
/obj/structure/flora/tree/jungle/small/style_random,
/turf/open/floor/grass,
/area/ruin/powered/hermit)
"TL" = (
/turf/closed/wall/prefab_plastic,
/area/ruin/powered/hermit)
"TW" = (
/obj/effect/mob_spawn/corpse/human/crater_constructor,
/turf/open/misc/asteroid/snow/icemoon,
/area/icemoon/underground/explored)
"WK" = (
/obj/item/tank/internals/emergency_oxygen/engi,
/turf/open/misc/dirt/station,
/area/ruin/powered/hermit)
"Xl" = (
/turf/open/floor/plating,
/area/ruin/powered/hermit)
"Yi" = (
/obj/item/seeds/plump,
/obj/item/seeds/plump,
/obj/item/seeds/tree,
/obj/item/seeds/reishi,
/obj/structure/table/wood,
/obj/item/food/grown/mushroom/glowshroom,
/turf/open/misc/dirt/station,
/area/ruin/powered/hermit)
"YA" = (
/obj/item/reagent_containers/cup/bucket/wooden,
/turf/open/misc/dirt/station,
/area/ruin/powered/hermit)
"YN" = (
/turf/closed/mineral/snowmountain/icemoon/unscrapeable,
/area/icemoon/underground/explored)

(1,1,1) = {"
QD
QD
QD
QD
QD
QD
QD
QD
QD
QD
QD
QD
QD
QD
QD
QD
"}
(2,1,1) = {"
QD
QD
QD
QD
YN
YN
YN
YN
YN
YN
YN
YN
YN
aM
QD
QD
"}
(3,1,1) = {"
QD
QD
QD
YN
YN
YN
YN
YN
YN
YN
YN
YN
YN
YN
YN
YN
"}
(4,1,1) = {"
QD
QD
YN
YN
YN
YN
YN
YN
YN
YN
YN
YN
YN
YN
YN
YN
"}
(5,1,1) = {"
QD
YN
YN
YN
YN
YN
YN
YN
YN
TW
aM
il
aM
aM
aM
aM
"}
(6,1,1) = {"
YN
YN
YN
YN
HD
js
TL
TL
TL
TL
TL
TL
aM
aM
Rr
aM
"}
(7,1,1) = {"
YN
YN
YN
mR
Yi
Lf
TL
ec
ii
ha
mN
TL
aM
aM
aM
il
"}
(8,1,1) = {"
YN
YN
uw
oh
GU
cI
TL
hN
JI
mN
mN
bM
aM
aM
Rr
aM
"}
(9,1,1) = {"
YN
jG
sj
xN
Si
oJ
dY
JI
mN
sC
wf
TL
aM
aM
aM
CR
"}
(10,1,1) = {"
YN
YN
uw
Rd
oh
YA
Xl
Xl
Xl
TL
TL
TL
Qr
aM
aM
aM
"}
(11,1,1) = {"
YN
YN
YN
YN
uw
oh
bp
wH
WK
gr
oh
YN
YN
aM
aM
Rr
"}
(12,1,1) = {"
QD
YN
YN
YN
YN
zd
io
jG
YN
YN
YN
YN
YN
aM
aM
aM
"}
(13,1,1) = {"
QD
YN
YN
YN
YN
YN
YN
YN
YN
YN
YN
YN
aM
aM
Rr
aM
"}
(14,1,1) = {"
QD
QD
YN
YN
YN
YN
YN
YN
YN
YN
YN
YN
Rr
aM
aM
aM
"}
(15,1,1) = {"
QD
QD
QD
QD
YN
YN
YN
YN
aM
aM
aM
aM
aM
aM
aM
aM
"}
(16,1,1) = {"
QD
QD
QD
QD
QD
QD
QD
QD
QD
QD
QD
aM
aM
QD
QD
QD
"}
