//MAP CONVERTED BY dmm2tgm.py THIS HEADER COMMENT PREVENTS RECONVERSION, DO NOT REMOVE
"a" = (
/turf/template_noop,
/area/template_noop)
"j" = (
/turf/closed/wall/mineral/titanium,
/area/shuttle/escape)
"l" = (
/obj/machinery/door/airlock/shuttle{
	name = "Emergency Shuttle Airlock"
	},
/obj/effect/turf_decal/stripes/line{
	dir = 8
	},
/obj/effect/turf_decal/stripes/line{
	dir = 4
	},
/obj/docking_port/mobile/emergency{
	name = "Crater Emergency Shuttle"
	},
/turf/open/floor/plating,
/area/shuttle/escape)
"t" = (
/turf/closed/wall/mineral/titanium/nodiagonal,
/area/shuttle/escape)
"M" = (
/obj/machinery/door/airlock/shuttle{
	name = "Emergency Shuttle Airlock"
	},
/obj/effect/turf_decal/stripes/line{
	dir = 8
	},
/obj/effect/turf_decal/stripes/line{
	dir = 4
	},
/turf/open/floor/plating,
/area/shuttle/escape)
"S" = (
/obj/effect/spawner/structure/window/reinforced/shuttle,
/turf/open/floor/plating,
/area/shuttle/escape)
"X" = (
/turf/template_noop,
/area/shuttle/escape)

(1,1,1) = {"
a
a
a
a
a
a
a
a
j
M
t
l
j
a
a
a
j
M
t
M
j
a
a
a
a
a
a
a
a
a
"}
(2,1,1) = {"
a
a
a
a
a
a
a
a
j
X
X
X
t
a
a
a
t
X
X
X
t
a
a
a
a
a
a
a
a
a
"}
(3,1,1) = {"
a
a
a
a
a
a
a
a
j
X
X
X
t
S
S
S
t
X
X
X
t
a
a
a
a
a
a
a
a
a
"}
(4,1,1) = {"
a
a
a
a
a
a
a
a
X
X
X
X
X
X
X
X
X
X
X
X
X
X
a
a
a
a
a
a
a
a
"}
(5,1,1) = {"
a
a
a
a
a
a
a
a
X
X
X
X
X
X
X
X
X
X
X
X
X
X
a
a
a
a
a
a
a
a
"}
(6,1,1) = {"
a
a
a
a
a
a
a
a
X
X
X
X
X
X
X
X
X
X
X
X
X
X
a
a
a
a
a
a
a
a
"}
(7,1,1) = {"
a
a
a
a
a
a
a
a
X
X
X
X
X
X
X
X
X
X
X
X
X
X
a
a
a
a
a
a
a
a
"}
(8,1,1) = {"
a
a
a
a
a
a
a
a
X
X
X
X
X
X
X
X
X
X
X
X
X
X
a
a
a
a
a
a
a
a
"}
(9,1,1) = {"
a
a
a
a
a
a
a
a
X
X
X
X
X
X
X
X
X
X
X
X
X
X
a
a
a
a
a
a
a
a
"}
(10,1,1) = {"
a
a
a
a
a
a
a
a
X
X
X
X
X
X
X
X
X
X
X
X
X
X
a
a
a
a
a
a
a
a
"}
(11,1,1) = {"
a
a
a
a
a
a
a
a
X
X
X
X
X
X
X
X
X
X
X
X
X
X
a
a
a
a
a
a
a
a
"}
(12,1,1) = {"
a
a
a
a
a
a
a
a
X
X
X
X
X
X
X
X
X
X
X
X
X
X
a
a
a
a
a
a
a
a
"}
(13,1,1) = {"
a
a
a
a
a
a
a
a
X
X
X
X
X
X
X
X
X
X
X
X
X
X
a
a
a
a
a
a
a
a
"}
(14,1,1) = {"
a
a
a
a
a
a
a
a
X
X
X
X
X
X
X
X
X
X
X
X
X
X
a
a
a
a
a
a
a
a
"}
(15,1,1) = {"
a
a
a
a
a
a
a
a
t
X
X
X
t
S
S
S
j
X
X
X
j
a
a
a
a
a
a
a
a
a
"}
(16,1,1) = {"
a
a
a
a
a
a
a
a
t
X
X
X
t
a
a
a
t
X
X
X
t
a
a
a
a
a
a
a
a
a
"}
(17,1,1) = {"
a
a
a
a
a
a
a
a
j
M
t
M
j
a
a
a
t
M
t
M
t
a
a
a
a
a
a
a
a
a
"}
